
1980 (53rd)
WRITING (Screenplay Based on Material from Another Medium)
	
Breaker Morant -- Jonathan Hardy, David Stevens, Bruce Beresford
	
Coal Miner's Daughter -- Tom Rickman
	
The Elephant Man -- Christopher DeVore, Eric Bergren, David Lynch
*	
Ordinary People -- Alvin Sargent
	
The Stunt Man -- Screenplay by Lawrence B. Marcus; Adaptation by Richard Rush
WRITING (Screenplay Written Directly for the Screen)
	
Brubaker -- Screenplay by W. D. Richter; Story by W. D. Richter, Arthur Ross
	
Fame -- Christopher Gore
*	
Melvin and Howard -- Bo Goldman
	
Mon Oncle D'Amerique -- Jean Gruault
	
Private Benjamin -- Nancy Meyers, Charles Shyer, Harvey Miller

1981 (54th)
WRITING (Screenplay Based on Material from Another Medium)
	
The French Lieutenant's Woman -- Harold Pinter
*	
On Golden Pond -- Ernest Thompson
	
Pennies from Heaven -- Dennis Potter
	
Prince of the City -- Jay Presson Allen, Sidney Lumet
	
Ragtime -- Michael Weller
WRITING (Screenplay Written Directly for the Screen)
	
Absence of Malice -- Kurt Luedtke
	
Arthur -- Steve Gordon
	
Atlantic City -- John Guare
*	
Chariots of Fire -- Colin Welland
	
Reds -- Warren Beatty, Trevor Griffiths

1982 (55th)
WRITING (Screenplay Based on Material from Another Medium)
	
Das Boot -- Wolfgang Petersen
*	
Missing -- Costa-Gavras, Donald Stewart
	
Sophie's Choice -- Alan J. Pakula
	
The Verdict -- David Mamet
	
Victor/Victoria -- Blake Edwards
WRITING (Screenplay Written Directly for the Screen)
	
Diner -- Barry Levinson
	
E.T. The Extra-Terrestrial -- Melissa Mathison
*	
Gandhi -- John Briley
	
An Officer and a Gentleman -- Douglas Day Stewart
	
Tootsie -- Screenplay by Larry Gelbart, Murray Schisgal; Story by Don McGuire, Larry Gelbart

1983 (56th)
WRITING (Screenplay Based on Material from Another Medium)
	
Betrayal -- Harold Pinter
	
The Dresser -- Ronald Harwood
	
Educating Rita -- Willy Russell
	
Reuben, Reuben -- Julius J. Epstein
*	
Terms of Endearment -- James L. Brooks
WRITING (Screenplay Written Directly for the Screen)
	
The Big Chill -- Lawrence Kasdan, Barbara Benedek
	
Fanny & Alexander -- Ingmar Bergman
	
Silkwood -- Nora Ephron, Alice Arlen
*	
Tender Mercies -- Horton Foote
	
WarGames -- Lawrence Lasker, Walter F. Parkes

1984 (57th)
WRITING (Screenplay Based on Material from Another Medium)
*	
Amadeus -- Peter Shaffer
	
Greystoke: The Legend of Tarzan, Lord of the Apes -- P.H. Vazak, Michael Austin
	
The Killing Fields -- Bruce Robinson
	
A Passage to India -- David Lean
	
A Soldier's Story -- Charles Fuller
WRITING (Screenplay Written Directly for the Screen)
	
Beverly Hills Cop -- Screenplay by Daniel Petrie, Jr.; Story by Danilo Bach, Daniel Petrie, Jr.
	
Broadway Danny Rose -- Woody Allen
	
El Norte -- Gregory Nava, Anna Thomas
*	
Places in the Heart -- Robert Benton
	
Splash -- Screenplay by Lowell Ganz, Babaloo Mandel, Bruce Jay Friedman; Screen Story by Bruce Jay Friedman; Based on a story by Brian Grazer

1985 (58th)
WRITING (Screenplay Based on Material from Another Medium)
	
The Color Purple -- Menno Meyjes
	
Kiss of the Spider Woman -- Leonard Schrader
*	
Out of Africa -- Kurt Luedtke
	
Prizzi's Honor -- Richard Condon, Janet Roach
	
The Trip to Bountiful -- Horton Foote
WRITING (Screenplay Written Directly for the Screen)
	
Back to the Future -- Robert Zemeckis, Bob Gale
	
Brazil -- Terry Gilliam, Tom Stoppard, Charles McKeown
	
The Official Story -- Luis Puenzo, Aida Bortnik
	
The Purple Rose of Cairo -- Woody Allen
*	
Witness -- Screenplay by Earl W. Wallace, William Kelley; Story by William Kelley, Pamela Wallace, Earl W. Wallace

1986 (59th)
WRITING (Screenplay Based on Material from Another Medium)
	
Children of a Lesser God -- Hesper Anderson, Mark Medoff
	
The Color of Money -- Richard Price
	
Crimes of the Heart -- Beth Henley
*	
A Room with a View -- Ruth Prawer Jhabvala
	
Stand by Me -- Raynold Gideon, Bruce A. Evans
WRITING (Screenplay Written Directly for the Screen)
	
'Crocodile' Dundee -- Screenplay by Paul Hogan, Ken Shadie, John Cornell; Story by Paul Hogan
*	
Hannah and Her Sisters -- Woody Allen
	
My Beautiful Laundrette -- Hanif Kureishi
	
Platoon -- Oliver Stone
	
Salvador -- Oliver Stone, Richard Boyle

1987 (60th)
WRITING (Screenplay Based on Material from Another Medium)
	
The Dead -- Tony Huston
	
Fatal Attraction -- James Dearden
	
Full Metal Jacket -- Stanley Kubrick, Michael Herr, Gustav Hasford
*	
The Last Emperor -- Mark Peploe, Bernardo Bertolucci
	
My Life as a Dog -- Lasse Hallström, Reidar Jönsson, Brasse Brännström, Per Berglund
WRITING (Screenplay Written Directly for the Screen)
	
Au Revoir Les Enfants (Goodbye, Children) -- Louis Malle
	
Broadcast News -- James L. Brooks
	
Hope and Glory -- John Boorman
*	
Moonstruck -- John Patrick Shanley
	
Radio Days -- Woody Allen

1988 (61st)
WRITING (Screenplay Based on Material from Another Medium)
	
The Accidental Tourist -- Frank Galati, Lawrence Kasdan
*	
Dangerous Liaisons -- Christopher Hampton
	
Gorillas in the Mist -- Screenplay by Anna Hamilton Phelan; Story by Anna Hamilton Phelan, Tab Murphy
	
Little Dorrit -- Christine Edzard
	
The Unbearable Lightness of Being -- Jean-Claude Carrière, Philip Kaufman
WRITING (Screenplay Written Directly for the Screen)
	
Big -- Gary Ross, Anne Spielberg
	
Bull Durham -- Ron Shelton
	
A Fish Called Wanda -- Screenplay by John Cleese; Story by John Cleese, Charles Crichton
*	
Rain Man -- Screenplay by Ronald Bass, Barry Morrow; Story by Barry Morrow
	
Running on Empty -- Naomi Foner

1989 (62nd)
WRITING (Screenplay Based on Material from Another Medium)
	
Born on the Fourth of July -- Oliver Stone, Ron Kovic
*	
Driving Miss Daisy -- Alfred Uhry
	
Enemies, A Love Story -- Roger L. Simon, Paul Mazursky
	
Field of Dreams -- Phil Alden Robinson
	
My Left Foot -- Jim Sheridan, Shane Connaughton
WRITING (Screenplay Written Directly for the Screen)
	
Crimes and Misdemeanors -- Woody Allen
*	
Dead Poets Society -- Tom Schulman
	
Do the Right Thing -- Spike Lee
	
sex, lies, and videotape -- Steven Soderbergh
	
When Harry Met Sally... -- Nora Ephron

1990 (63rd)
WRITING (Screenplay Based on Material from Another Medium)
	
Awakenings -- Steven Zaillian
*	
Dances With Wolves -- Michael Blake
	
Good Fellas -- Nicholas Pileggi, Martin Scorsese
	
The Grifters -- Donald E. Westlake
	
Reversal of Fortune -- Nicholas Kazan
WRITING (Screenplay Written Directly for the Screen)
	
Alice -- Woody Allen
	
Avalon -- Barry Levinson
*	
Ghost -- Bruce Joel Rubin
	
Green Card -- Peter Weir
	
Metropolitan -- Whit Stillman

1991 (64th)
WRITING (Screenplay Based on Material Previously Produced or Published)
	
Europa Europa -- Agnieszka Holland
	
Fried Green Tomatoes -- Fannie Flagg, Carol Sobieski
	
JFK -- Oliver Stone, Zachary Sklar
	
The Prince of Tides -- Pat Conroy, Becky Johnston
*	
The Silence of the Lambs -- Ted Tally
WRITING (Screenplay Written Directly for the Screen)
	
Boyz N the Hood -- John Singleton
	
Bugsy -- James Toback
	
The Fisher King -- Richard LaGravenese
	
Grand Canyon -- Lawrence Kasdan, Meg Kasdan
*	
Thelma & Louise -- Callie Khouri

1992 (65th)
WRITING (Screenplay Based on Material Previously Produced or Published)
	
Enchanted April -- Peter Barnes
*	
Howards End -- Ruth Prawer Jhabvala
	
The Player -- Michael Tolkin
	
A River Runs through It -- Richard Friedenberg
	
Scent of a Woman -- Bo Goldman
WRITING (Screenplay Written Directly for the Screen)
*	
The Crying Game -- Neil Jordan
	
Husbands and Wives -- Woody Allen
	
Lorenzo's Oil -- George Miller, Nick Enright
	
Passion Fish -- John Sayles
	
Unforgiven -- David Webb Peoples

1993 (66th)
WRITING (Screenplay Based on Material Previously Produced or Published)
	
The Age of Innocence -- Jay Cocks, Martin Scorsese
	
In the Name of the Father -- Terry George, Jim Sheridan
	
The Remains of the Day -- Ruth Prawer Jhabvala
*	
Schindler's List -- Steven Zaillian
	
Shadowlands -- William Nicholson
WRITING (Screenplay Written Directly for the Screen)
	
Dave -- Gary Ross
	
In the Line of Fire -- Jeff Maguire
	
Philadelphia -- Ron Nyswaner
*	
The Piano -- Jane Campion
	
Sleepless in Seattle -- Screenplay by Nora Ephron, David S. Ward, Jeff Arch; Story by Jeff Arch

1994 (67th)
WRITING (Screenplay Based on Material Previously Produced or Published)
*	
Forrest Gump -- Eric Roth
	
The Madness of King George -- Alan Bennett
	
Nobody's Fool -- Robert Benton
	
Quiz Show -- Paul Attanasio
	
The Shawshank Redemption -- Frank Darabont
WRITING (Screenplay Written Directly for the Screen)
	
Bullets over Broadway -- Woody Allen, Douglas McGrath
	
Four Weddings and a Funeral -- Richard Curtis
	
Heavenly Creatures -- Frances Walsh, Peter Jackson
*	
Pulp Fiction -- Screenplay by Quentin Tarantino; Stories by Quentin Tarantino & Roger Avary
	
Red -- Krzysztof Piesiewicz, Krzysztof Kieslowski

1995 (68th)
WRITING (Screenplay Based on Material Previously Produced or Published)
	
Apollo 13 -- William Broyles, Jr., Al Reinert
	
Babe -- George Miller, Chris Noonan
	
Leaving Las Vegas -- Mike Figgis
	
The Postman (Il Postino) -- Anna Pavignano, Michael Radford, Furio Scarpelli, Giacomo Scarpelli, Massimo Troisi
*	
Sense and Sensibility -- Emma Thompson
WRITING (Screenplay Written Directly for the Screen)
	
Braveheart -- Randall Wallace
	
Mighty Aphrodite -- Woody Allen
	
Nixon -- Stephen J. Rivele, Christopher Wilkinson, Oliver Stone
	
Toy Story -- Screenplay by Joss Whedon, Andrew Stanton, Joel Cohen, Alec Sokolow; Story by John Lasseter, Peter Docter, Andrew Stanton, Joe Ranft
*	
The Usual Suspects -- Christopher McQuarrie

1996 (69th)
WRITING (Screenplay Based on Material Previously Produced or Published)
	
The Crucible -- Arthur Miller
	
The English Patient -- Anthony Minghella
	
Hamlet -- Kenneth Branagh
*	
Sling Blade -- Billy Bob Thornton
	
Trainspotting -- John Hodge
WRITING (Screenplay Written Directly for the Screen)
*	
Fargo -- Ethan Coen, Joel Coen
	
Jerry Maguire -- Cameron Crowe
	
Lone Star -- John Sayles
	
Secrets & Lies -- Mike Leigh
	
Shine -- Screenplay by Jan Sardi; Story by Scott Hicks

1997 (70th)
WRITING (Screenplay Based on Material Previously Produced or Published)
	
Donnie Brasco -- Paul Attanasio
*	
L.A. Confidential -- Brian Helgeland, Curtis Hanson
	
The Sweet Hereafter -- Atom Egoyan
	
Wag the Dog -- Hilary Henkin, David Mamet
	
The Wings of the Dove -- Hossein Amini
WRITING (Screenplay Written Directly for the Screen)
	
As Good as It Gets -- Screenplay by Mark Andrus, James L. Brooks; Story by Mark Andrus
	
Boogie Nights -- Paul Thomas Anderson
	
Deconstructing Harry -- Woody Allen
	
The Full Monty -- Simon Beaufoy
*	
Good Will Hunting -- Ben Affleck, Matt Damon

1998 (71st)
WRITING (Screenplay Based on Material Previously Produced or Published)
*	
Gods and Monsters -- Bill Condon
	
Out of Sight -- Scott Frank
	
Primary Colors -- Elaine May
	
A Simple Plan -- Scott B. Smith
	
The Thin Red Line -- Terrence Malick
WRITING (Screenplay Written Directly for the Screen)
	
Bulworth -- Screenplay by Warren Beatty, Jeremy Pikser; Story by Warren Beatty
	
Life Is Beautiful -- Vincenzo Cerami, Roberto Benigni
	
Saving Private Ryan -- Robert Rodat
*	
Shakespeare in Love -- Marc Norman, Tom Stoppard
	
The Truman Show -- Andrew Niccol

1999 (72nd)
WRITING (Screenplay Based on Material Previously Produced or Published)
*	
The Cider House Rules -- John Irving
	
Election -- Alexander Payne, Jim Taylor
	
The Green Mile -- Frank Darabont
	
The Insider -- Eric Roth, Michael Mann
	
The Talented Mr. Ripley -- Anthony Minghella
WRITING (Screenplay Written Directly for the Screen)
*	
American Beauty -- Alan Ball
	
Being John Malkovich -- Charlie Kaufman
	
Magnolia -- Paul Thomas Anderson
	
The Sixth Sense -- M. Night Shyamalan
	
Topsy-Turvy -- Mike Leigh

2000 (73rd)
WRITING (Screenplay Based on Material Previously Produced or Published)
	
Chocolat -- Screenplay by Robert Nelson Jacobs
	
Crouching Tiger, Hidden Dragon -- Written by Wang Hui Ling and James Schamus and Tsai Kuo Jung
	
O Brother, Where Art Thou? -- Written by Ethan Coen & Joel Coen
*	
Traffic -- Screenplay by Stephen Gaghan
	
Wonder Boys -- Screenplay by Steve Kloves
WRITING (Screenplay Written Directly for the Screen)
*	
Almost Famous -- Written by Cameron Crowe
	
Billy Elliot -- Written by Lee Hall
	
Erin Brockovich -- Written by Susannah Grant
	
Gladiator -- Screenplay by David Franzoni and John Logan and William Nicholson; Story by David Franzoni
	
You Can Count on Me -- Written by Kenneth Lonergan

2001 (74th)
WRITING (Screenplay Based on Material Previously Produced or Published)
*	
A Beautiful Mind -- Written by Akiva Goldsman
	
Ghost World -- Written by Daniel Clowes & Terry Zwigoff
	
In the Bedroom -- Screenplay by Rob Festinger and Todd Field
	
The Lord of the Rings: The Fellowship of the Ring -- Screenplay by Fran Walsh, Philippa Boyens, Peter Jackson
	
Shrek -- Written by Ted Elliott & Terry Rossio and Joe Stillman and Roger S.H. Schulman
WRITING (Screenplay Written Directly for the Screen)
	
Amélie -- Screenplay by Guillaume Laurant and Jean-Pierre Jeunet; Dialogue by Guillaume Laurant
*	
Gosford Park -- Written by Julian Fellowes
	
Memento -- Screenplay by Christopher Nolan; Story by Jonathan Nolan
	
Monster's Ball -- Written by Milo Addica & Will Rokos
	
The Royal Tenenbaums -- Written by Wes Anderson & Owen Wilson

2002 (75th)
WRITING (Adapted Screenplay)
	
About a Boy -- Screenplay by Peter Hedges and Chris Weitz & Paul Weitz
	
Adaptation -- Screenplay by Charlie Kaufman and Donald Kaufman
	
Chicago -- Screenplay by Bill Condon
	
The Hours -- Screenplay by David Hare
*	
The Pianist -- Screenplay by Ronald Harwood
WRITING (Original Screenplay)
	
Far from Heaven -- Written by Todd Haynes
	
Gangs of New York -- Screenplay by Jay Cocks and Steve Zaillian and Kenneth Lonergan; Story by Jay Cocks
	
My Big Fat Greek Wedding -- Written by Nia Vardalos
*	
Talk to Her -- Written by Pedro Almodóvar
	
Y Tu Mamá También -- Written by Carlos Cuarón and Alfonso Cuarón

2003 (76th)
WRITING (Adapted Screenplay)
	
American Splendor -- Written by Robert Pulcini & Shari Springer Berman
	
City of God -- Screenplay by Braulio Mantovani
*	
The Lord of the Rings: The Return of the King -- Screenplay by Fran Walsh, Philippa Boyens & Peter Jackson
	
Mystic River -- Screenplay by Brian Helgeland
	
Seabiscuit -- Written for the Screen by Gary Ross
WRITING (Original Screenplay)
	
The Barbarian Invasions -- Written by Denys Arcand
	
Dirty Pretty Things -- Written by Steven Knight
	
Finding Nemo -- Screenplay by Andrew Stanton, Bob Peterson and David Reynolds; Original Story by Andrew Stanton
	
In America -- Written by Jim Sheridan & Naomi Sheridan & Kirsten Sheridan
*	
Lost in Translation -- Written by Sofia Coppola

2004 (77th)
WRITING (Adapted Screenplay)
	
Before Sunset -- Screenplay by Richard Linklater & Julie Delpy & Ethan Hawke; Story by Richard Linklater & Kim Krizan
	
Finding Neverland -- Screenplay by David Magee
	
Million Dollar Baby -- Screenplay by Paul Haggis
	
The Motorcycle Diaries -- Screenplay by José Rivera
*	
Sideways -- Screenplay by Alexander Payne & Jim Taylor
WRITING (Original Screenplay)
	
The Aviator -- Written by John Logan
*	
Eternal Sunshine of the Spotless Mind -- Screenplay by Charlie Kaufman; Story by Charlie Kaufman & Michel Gondry & Pierre Bismuth
	
Hotel Rwanda -- Written by Keir Pearson & Terry George
	
The Incredibles -- Written by Brad Bird
	
Vera Drake -- Written by Mike Leigh

2005 (78th)
WRITING (Adapted Screenplay)
*	
Brokeback Mountain -- Screenplay by Larry McMurtry & Diana Ossana
	
Capote -- Screenplay by Dan Futterman
	
The Constant Gardener -- Screenplay by Jeffrey Caine
	
A History of Violence -- Screenplay by Josh Olson
	
Munich -- Screenplay by Tony Kushner and Eric Roth
WRITING (Original Screenplay)
*	
Crash -- Screenplay by Paul Haggis & Bobby Moresco; Story by Paul Haggis
	
Good Night, and Good Luck. -- Screenplay by George Clooney & Grant Heslov
	
Match Point -- Written by Woody Allen
	
The Squid and the Whale -- Written by Noah Baumbach
	
Syriana -- Written by Stephen Gaghan

2006 (79th)
WRITING (Adapted Screenplay)
	
Borat Cultural Learnings of America for Make Benefit Glorious Nation of Kazakhstan -- Screenplay by Sacha Baron Cohen & Anthony Hines & Peter Baynham & Dan Mazer; Story by Sacha Baron Cohen & Peter Baynham & Anthony Hines & Todd Phillips
	
Children of Men -- Screenplay by Alfonso Cuarón & Timothy J. Sexton and David Arata and Mark Fergus & Hawk Ostby
*	
The Departed -- Screenplay by William Monahan
	
Little Children -- Screenplay by Todd Field & Tom Perrotta
	
Notes on a Scandal -- Screenplay by Patrick Marber
WRITING (Original Screenplay)
	
Babel -- Written by Guillermo Arriaga
	
Letters from Iwo Jima -- Screenplay by Iris Yamashita; Story by Iris Yamashita & Paul Haggis
*	
Little Miss Sunshine -- Written by Michael Arndt
	
Pan's Labyrinth -- Written by Guillermo del Toro
	
The Queen -- Written by Peter Morgan

2007 (80th)
WRITING (Adapted Screenplay)
	
Atonement -- Screenplay by Christopher Hampton
	
Away from Her -- Written by Sarah Polley
	
The Diving Bell and the Butterfly -- Screenplay by Ronald Harwood
*	
No Country for Old Men -- Written for the screen by Joel Coen & Ethan Coen
	
There Will Be Blood -- Written for the Screen by Paul Thomas Anderson
WRITING (Original Screenplay)
*	
Juno -- Written by Diablo Cody
	
Lars and the Real Girl -- Written by Nancy Oliver
	
Michael Clayton -- Written by Tony Gilroy
	
Ratatouille -- Screenplay by Brad Bird; Story by Jan Pinkava, Jim Capobianco, Brad Bird
	
The Savages -- Written by Tamara Jenkins

2008 (81st)
WRITING (Adapted Screenplay)
	
The Curious Case of Benjamin Button -- Screenplay by Eric Roth; Screen story by Eric Roth and Robin Swicord
	
Doubt -- Written by John Patrick Shanley
	
Frost/Nixon -- Screenplay by Peter Morgan
	
The Reader -- Screenplay by David Hare
*	
Slumdog Millionaire -- Screenplay by Simon Beaufoy
WRITING (Original Screenplay)
	
Frozen River -- Written by Courtney Hunt
	
Happy-Go-Lucky -- Written by Mike Leigh
	
In Bruges -- Written by Martin McDonagh
*	
Milk -- Written by Dustin Lance Black
	
WALL-E -- Screenplay by Andrew Stanton, Jim Reardon; Original story by Andrew Stanton, Pete Docter

2009 (82nd)
WRITING (Adapted Screenplay)
	
District 9 -- Written by Neill Blomkamp and Terri Tatchell
	
An Education -- Screenplay by Nick Hornby
	
In the Loop -- Screenplay by Jesse Armstrong, Simon Blackwell, Armando Iannucci, Tony Roche
*	
Precious: Based on the Novel 'Push' by Sapphire -- Screenplay by Geoffrey Fletcher
	
Up in the Air -- Screenplay by Jason Reitman and Sheldon Turner
WRITING (Original Screenplay)
*	
The Hurt Locker -- Written by Mark Boal
	
Inglourious Basterds -- Written by Quentin Tarantino
	
The Messenger -- Written by Alessandro Camon & Oren Moverman
	
A Serious Man -- Written by Joel Coen & Ethan Coen
	
Up -- Screenplay by Bob Peterson, Pete Docter; Story by Pete Docter, Bob Peterson, Tom McCarthy

2010 (83rd)
WRITING (Adapted Screenplay)
	
127 Hours -- Screenplay by Danny Boyle & Simon Beaufoy
*	
The Social Network -- Screenplay by Aaron Sorkin
	
Toy Story 3 -- Screenplay by Michael Arndt; Story by John Lasseter, Andrew Stanton and Lee Unkrich
	
True Grit -- Written for the screen by Joel Coen & Ethan Coen
	
Winter's Bone -- Adapted for the screen by Debra Granik & Anne Rosellini
WRITING (Original Screenplay)
	
Another Year -- Written by Mike Leigh
	
The Fighter -- Screenplay by Scott Silver and Paul Tamasy & Eric Johnson; Story by Keith Dorrington & Paul Tamasy & Eric Johnson
	
Inception -- Written by Christopher Nolan
	
The Kids Are All Right -- Written by Lisa Cholodenko & Stuart Blumberg
*	
The King's Speech -- Screenplay by David Seidler

2011 (84th)
WRITING (Adapted Screenplay)
*	
The Descendants -- Screenplay by Alexander Payne and Nat Faxon & Jim Rash
	
Hugo -- Screenplay by John Logan
	
The Ides of March -- Screenplay by George Clooney & Grant Heslov and Beau Willimon
	
Moneyball -- Screenplay by Steven Zaillian and Aaron Sorkin; Story by Stan Chervin
	
Tinker Tailor Soldier Spy -- Screenplay by Bridget O'Connor & Peter Straughan
WRITING (Original Screenplay)
	
The Artist -- Written by Michel Hazanavicius
	
Bridesmaids -- Written by Annie Mumolo & Kristen Wiig
	
Margin Call -- Written by J.C. Chandor
*	
Midnight in Paris -- Written by Woody Allen
	
A Separation -- Written by Asghar Farhadi

2012 (85th)
WRITING (Adapted Screenplay)
*	
Argo -- Screenplay by Chris Terrio
	
Beasts of the Southern Wild -- Screenplay by Lucy Alibar & Benh Zeitlin
	
Life of Pi -- Screenplay by David Magee
	
Lincoln -- Screenplay by Tony Kushner
	
Silver Linings Playbook -- Screenplay by David O. Russell
WRITING (Original Screenplay)
	
Amour -- Written by Michael Haneke
*	
Django Unchained -- Written by Quentin Tarantino
	
Flight -- Written by John Gatins
	
Moonrise Kingdom -- Written by Wes Anderson & Roman Coppola
	
Zero Dark Thirty -- Written by Mark Boal

2013 (86th)
WRITING (Adapted Screenplay)
	
Before Midnight -- Written by Richard Linklater, Julie Delpy, Ethan Hawke
	
Captain Phillips -- Screenplay by Billy Ray
	
Philomena -- Screenplay by Steve Coogan and Jeff Pope
*	
12 Years a Slave -- Screenplay by John Ridley
	
The Wolf of Wall Street -- Screenplay by Terence Winter
WRITING (Original Screenplay)
	
American Hustle -- Written by Eric Warren Singer and David O. Russell
	
Blue Jasmine -- Written by Woody Allen
	
Dallas Buyers Club -- Written by Craig Borten & Melisa Wallack
*	
Her -- Written by Spike Jonze
	
Nebraska -- Written by Bob Nelson

2014 (87th)
WRITING (Adapted Screenplay)
	
American Sniper -- Written by Jason Hall
*	
The Imitation Game -- Written by Graham Moore
	
Inherent Vice -- Written for the screen by Paul Thomas Anderson
	
The Theory of Everything -- Screenplay by Anthony McCarten
	
Whiplash -- Written by Damien Chazelle
WRITING (Original Screenplay)
*	
Birdman or (The Unexpected Virtue of Ignorance) -- Written by Alejandro G. Iñárritu, Nicolás Giacobone, Alexander Dinelaris, Jr. & Armando Bo
	
Boyhood -- Written by Richard Linklater
	
Foxcatcher -- Written by E. Max Frye and Dan Futterman
	
The Grand Budapest Hotel -- Screenplay by Wes Anderson; Story by Wes Anderson & Hugo Guinness
	
Nightcrawler -- Written by Dan Gilroy

2015 (88th)
WRITING (Adapted Screenplay)
*	
The Big Short -- Screenplay by Charles Randolph and Adam McKay
	
Brooklyn -- Screenplay by Nick Hornby
	
Carol -- Screenplay by Phyllis Nagy
	
The Martian -- Screenplay by Drew Goddard
	
Room -- Screenplay by Emma Donoghue
WRITING (Original Screenplay)
	
Bridge of Spies -- Written by Matt Charman and Ethan Coen & Joel Coen
	
Ex Machina -- Written by Alex Garland
	
Inside Out -- Screenplay by Pete Docter, Meg LeFauve, Josh Cooley; Original story by Pete Docter, Ronnie del Carmen
*	
Spotlight -- Written by Josh Singer & Tom McCarthy
	
Straight Outta Compton -- Screenplay by Jonathan Herman and Andrea Berloff; Story by S. Leigh Savidge & Alan Wenkus and Andrea Berloff